CarCount,BikeCount,BusCount,TruckCount,Total,Traffic Situation
31,0,4,4,39,0
49,0,3,3,55,0
46,0,3,6,55,0
51,0,2,5,58,0
57,6,15,16,94,0
44,0,5,4,53,0
37,0,1,4,42,0
42,4,4,5,55,0
51,0,9,7,67,0
34,0,4,7,45,0
45,0,1,1,47,0
45,0,1,3,49,0
50,0,3,0,53,0
34,0,4,4,42,0
129,22,42,1,194,1
144,16,49,0,209,1
111,28,20,3,162,0
67,11,10,16,104,0
65,24,7,16,112,0
94,27,7,16,144,0
94,20,8,7,129,0
67,29,5,10,111,0
56,12,2,14,84,0
57,13,3,11,84,0
129,22,42,1,194,1
144,16,49,0,209,1
111,28,20,3,162,0
120,27,46,3,196,1
102,39,47,1,189,1
145,23,27,0,195,1
114,37,21,5,177,1
108,18,22,1,149,0
122,28,33,1,184,1
114,39,30,3,186,1
150,36,25,1,212,1
107,10,49,2,168,1
124,24,22,0,170,1
77,16,39,29,161,1
15,23,30,21,89,0
32,22,38,21,113,1
68,13,29,24,134,1
27,16,36,30,109,0
76,7,11,15,109,0
41,23,20,17,101,0
33,10,3,29,75,0
58,8,14,29,109,0
65,7,11,26,109,0
47,9,6,29,91,0
38,10,5,25,78,0
57,8,12,29,106,0
20,6,4,20,50,0
24,9,14,23,70,0
52,10,13,21,96,0
79,15,36,18,148,1
84,24,22,18,148,0
59,19,35,16,129,1
88,26,31,19,164,1
24,11,32,13,80,0
110,17,23,20,170,1
29,26,5,6,66,0
43,26,11,20,100,0
68,28,9,15,120,0
108,16,8,18,150,0
101,26,8,14,149,0
141,31,36,6,214,1
120,25,28,5,178,1
137,23,44,5,209,1
124,11,30,7,172,1
145,25,49,7,226,1
122,37,23,8,190,1
136,30,20,9,195,1
145,18,40,9,212,1
138,34,28,5,205,1
123,10,29,8,170,1
105,15,21,9,150,0
75,22,20,11,128,0
90,12,10,13,125,0
102,22,20,16,160,0
61,18,15,27,121,1
70,8,14,6,98,0
80,17,12,34,143,1
62,12,14,19,107,0
96,5,11,13,125,0
102,6,12,13,133,0
91,14,15,6,126,0
95,8,17,13,133,0
75,15,12,21,123,1
53,21,20,10,104,0
13,1,0,19,33,0
10,0,1,24,35,0
16,2,0,33,51,0
11,1,0,29,41,0
18,2,1,13,34,0
15,0,1,11,27,0
14,1,0,33,48,0
17,2,0,22,41,0
12,2,1,17,32,0
18,0,0,29,47,0
16,1,0,14,31,0
20,0,0,14,34,0
20,1,1,30,52,0
15,0,1,23,39,0
16,0,1,26,43,0
18,4,0,11,33,0
17,3,1,36,57,0
14,4,1,10,29,0
18,2,1,25,46,0
12,2,0,19,33,0
11,4,0,30,45,0
19,1,1,36,57,0
10,4,0,36,50,0
20,1,1,32,54,0
15,5,1,40,61,0
104,6,5,1,116,0
109,25,3,8,145,0
82,23,8,20,133,0
81,25,1,18,125,0
95,16,10,1,122,0
91,24,7,6,128,0
81,30,10,0,121,0
125,13,26,2,166,1
125,39,49,3,216,1
125,34,37,1,197,1
125,19,25,4,173,1
125,15,49,0,189,1
125,32,50,5,212,1
125,38,50,1,214,1
125,29,29,3,186,1
125,31,48,4,208,1
125,32,50,0,207,1
125,31,45,0,201,1
125,21,20,1,167,0
125,28,36,0,189,1
39,10,37,16,102,0
89,8,12,13,122,0
51,16,16,13,96,0
17,9,18,28,72,0
48,25,36,21,130,1
93,7,30,16,146,1
55,15,36,15,121,1
51,10,8,22,91,0
51,7,3,24,85,0
51,9,7,30,97,0
51,7,14,20,92,0
51,10,14,20,95,0
51,10,6,22,89,0
51,8,11,22,92,0
51,6,10,26,93,0
51,7,7,27,92,0
104,17,25,20,166,0
6,28,27,14,75,0
54,29,37,9,129,1
43,13,30,20,106,0
60,21,26,11,118,1
101,23,8,20,152,0
62,26,19,11,118,0
39,24,13,11,87,0
90,20,35,7,152,1
109,30,22,20,181,1
68,26,25,20,139,0
142,22,37,6,207,1
113,14,20,5,152,0
142,13,37,8,200,1
108,23,26,9,166,1
122,29,30,7,188,1
133,12,30,7,182,1
118,23,38,10,189,1
121,35,26,8,190,1
116,23,20,8,167,0
132,12,27,8,179,1
144,17,33,7,201,1
103,21,11,11,146,0
107,15,10,15,147,0
50,10,10,17,87,0
108,15,10,6,139,0
108,24,15,29,176,1
101,6,15,13,135,0
55,17,12,19,103,0
77,7,20,16,120,0
91,12,19,8,130,0
95,25,17,29,166,1
78,17,17,27,139,1
98,16,16,21,151,1
86,13,11,35,145,1
18,4,0,16,38,0
18,5,0,12,35,0
18,2,1,25,46,0
18,1,0,17,36,0
18,5,0,21,44,0
18,0,1,12,31,0
18,3,1,28,50,0
18,4,1,40,63,0
18,1,1,39,59,0
18,4,0,30,52,0
18,5,1,13,37,0
18,2,0,37,57,0
18,0,0,13,31,0
18,5,0,11,34,0
18,5,1,12,36,0
18,1,1,16,36,0
18,1,1,34,54,0
18,1,0,24,43,0
18,0,0,23,41,0
18,0,0,27,45,0
18,5,0,28,51,0
18,1,0,14,33,0
18,5,0,25,48,0
18,4,1,30,53,0
18,5,1,30,54,0
62,24,7,2,95,0
51,23,6,1,81,0
114,23,10,19,166,0
85,22,9,9,125,0
102,24,4,20,150,0
101,18,3,17,139,0
116,19,0,17,152,0
117,38,50,5,210,1
114,32,34,2,182,1
120,17,23,1,161,0
145,20,25,2,192,1
125,30,48,1,204,1
103,27,45,1,176,1
114,20,43,1,178,1
145,10,44,1,200,1
147,31,20,4,202,1
104,24,40,0,168,1
124,11,22,0,157,0
101,37,31,4,173,1
144,30,37,1,212,1
24,18,37,18,97,0
24,8,17,25,74,0
16,22,12,20,70,0
26,2,39,26,93,0
90,7,18,15,130,0
59,6,11,11,87,0
28,7,22,18,75,0
60,5,14,21,100,0
69,9,8,23,109,0
59,9,12,26,106,0
24,10,5,21,60,0
41,7,7,21,76,0
48,10,9,29,96,0
59,10,14,23,106,0
67,7,12,28,114,1
52,9,8,20,89,0
45,26,29,10,110,0
14,21,7,18,60,0
55,22,24,10,111,0
45,14,39,5,103,0
90,17,16,11,134,0
33,21,25,5,84,0
118,25,31,13,187,1
86,28,13,5,132,0
105,29,22,12,168,1
10,19,26,8,63,0
46,22,18,9,95,0
105,35,48,6,194,1
135,37,34,5,211,1
103,29,44,6,182,1
113,13,42,10,178,1
103,20,27,9,159,1
150,13,20,9,192,1
116,25,33,8,182,1
109,16,41,9,175,1
112,11,50,5,178,1
104,31,30,5,170,1
146,18,40,6,210,1
110,24,10,29,173,1
60,15,12,25,112,1
103,9,14,29,155,1
102,6,15,6,129,0
51,17,16,8,92,0
62,12,11,18,103,0
103,14,12,5,134,0
50,7,11,23,91,0
80,14,20,6,120,0
98,13,18,21,150,1
53,25,20,13,111,0
52,8,10,27,97,0
71,23,13,21,128,1
17,3,0,29,49,0
20,5,1,36,62,0
15,0,0,32,47,0
15,0,1,20,36,0
14,2,0,23,39,0
13,1,0,29,43,0
14,5,0,31,50,0
16,3,0,33,52,0
18,4,1,15,38,0
20,0,1,23,44,0
19,3,0,16,38,0
10,3,0,12,25,0
10,4,0,23,37,0
12,5,0,29,46,0
10,0,0,39,49,0
16,2,1,21,40,0
18,4,1,36,59,0
15,1,0,14,30,0
17,4,0,13,34,0
18,3,1,24,46,0
19,2,0,11,32,0
19,3,0,21,43,0
19,3,1,31,54,0
14,2,1,19,36,0
11,0,0,27,38,0
27,6,1,11,45,0
33,11,6,13,63,0
63,6,7,10,86,0
58,13,4,15,90,0
57,11,7,10,85,0
63,10,6,12,91,0
74,9,0,15,98,0
71,9,7,10,97,0
33,9,6,13,61,0
29,6,1,12,48,0
32,9,3,11,55,0
57,14,3,11,85,0
31,11,0,14,56,0
30,9,3,10,52,0
61,8,7,12,88,0
47,10,4,10,71,0
80,16,4,15,115,0
49,10,2,10,71,0
58,7,5,13,83,0
53,19,1,10,83,0
132,47,25,0,204,1
131,52,15,0,198,1
171,59,27,3,260,1
131,43,20,3,197,1
177,56,12,4,249,1
160,47,30,3,240,1
178,68,28,4,278,1
169,70,20,3,262,1
133,56,25,2,216,1
151,52,13,0,216,1
179,46,27,3,255,1
144,68,20,0,232,1
162,46,19,2,229,1
159,44,23,2,228,1
174,67,30,1,272,1
136,57,29,4,226,1
156,42,12,3,213,1
175,63,19,3,260,1
172,62,20,2,256,1
171,49,15,0,235,1
172,65,18,2,257,1
176,50,13,1,240,1
153,50,23,3,229,1
148,64,27,0,239,1
56,28,6,2,92,0
88,26,25,0,139,0
82,23,14,0,119,0
77,20,7,0,104,0
66,24,1,0,91,0
72,22,8,2,104,0
62,28,21,2,113,0
66,26,4,1,97,0
85,20,4,0,109,0
87,24,11,2,124,0
67,28,25,0,120,0
70,26,16,2,114,0
62,20,20,1,103,0
67,29,1,0,97,0
65,25,1,1,92,0
76,24,23,0,123,0
42,1,5,11,59,0
42,10,3,1,56,0
31,11,1,12,55,0
47,7,3,6,63,0
28,7,2,4,41,0
22,3,6,1,32,0
29,1,7,5,42,0
43,9,1,11,64,0
23,3,3,8,37,0
21,2,5,15,43,0
31,2,1,9,43,0
15,5,0,18,38,0
11,2,0,15,28,0
12,0,1,17,30,0
18,3,0,18,39,0
19,1,0,31,51,0
17,0,0,22,39,0
15,5,0,14,34,0
15,1,1,24,41,0
18,4,0,33,55,0
14,4,0,34,52,0
14,0,1,19,34,0
19,3,0,36,58,0
10,4,1,21,36,0
19,1,0,19,39,0
18,5,0,26,49,0
17,1,1,25,44,0
20,2,0,12,34,0
15,5,0,15,35,0
11,4,0,14,29,0
14,3,1,18,36,0
13,2,0,39,54,0
17,5,0,29,51,0
13,5,0,31,49,0
18,5,0,35,58,0
15,4,0,16,35,0
55,15,5,3,78,0
76,10,7,9,102,0
98,0,9,19,126,0
98,12,6,6,122,0
103,2,10,20,135,0
93,17,8,12,130,0
115,27,9,16,167,0
120,12,22,3,157,0
142,18,27,0,187,1
117,29,49,2,197,1
126,36,24,0,186,1
110,39,38,5,192,1
149,20,39,5,213,1
109,29,23,5,166,0
124,34,24,4,186,1
149,35,32,1,217,1
125,32,38,4,199,1
101,23,38,1,163,1
137,36,30,0,203,1
139,15,21,3,178,1
19,3,29,9,60,0
13,11,39,7,70,0
31,2,29,27,89,0
18,24,21,22,85,0
26,12,14,13,65,0
31,15,13,28,87,0
12,22,8,11,53,0
54,5,13,23,95,0
59,7,13,21,100,0
58,8,6,23,95,0
53,8,9,25,95,0
54,7,7,20,88,0
39,10,4,29,82,0
38,9,8,22,77,0
36,5,10,23,74,0
68,6,12,24,110,0
50,18,26,14,108,0
120,28,22,20,190,1
60,14,28,9,111,0
105,14,8,19,146,0
89,27,18,8,142,0
28,17,31,10,86,0
79,14,23,6,122,0
15,11,30,14,70,0
77,27,23,18,145,0
19,14,24,6,63,0
79,13,28,7,127,1
114,10,22,9,155,0
150,30,22,5,207,1
142,23,25,7,197,1
111,36,25,6,178,1
143,37,38,8,226,1
120,37,43,10,210,1
147,20,49,7,223,0
140,22,27,5,194,1
128,37,20,9,194,1
114,23,42,10,189,1
117,20,22,9,168,1
93,24,17,23,157,1
65,15,15,8,103,0
100,22,14,8,144,0
85,12,11,18,126,0
56,7,12,12,87,0
50,12,15,18,95,0
74,9,11,12,106,0
73,15,18,7,113,0
99,13,20,30,162,1
110,14,17,8,149,0
82,5,12,34,133,1
58,19,12,17,106,0
70,10,14,32,126,1
10,1,0,33,44,0
14,1,1,40,56,0
17,1,1,17,36,0
12,4,1,22,39,0
15,0,0,16,31,0
13,4,0,25,42,0
14,5,1,12,32,0
18,1,1,35,55,0
18,5,1,19,43,0
19,3,0,38,60,0
13,0,1,12,26,0
20,0,1,38,59,0
20,1,1,24,46,0
17,3,1,17,38,0
12,3,1,35,51,0
19,0,1,30,50,0
19,2,1,30,52,0
18,1,0,16,35,0
11,0,0,31,42,0
10,1,1,12,24,0
16,1,0,24,41,0
18,3,0,28,49,0
20,1,1,39,61,0
19,3,1,27,50,0
14,1,1,34,50,0
61,26,1,16,104,0
72,26,6,4,108,0
86,24,3,18,131,0
75,1,8,10,94,0
75,1,7,9,92,0
93,5,4,1,103,0
111,6,2,5,124,0
111,18,41,2,172,1
114,27,46,0,187,1
139,19,50,2,210,1
109,14,38,1,162,1
105,16,22,3,146,0
150,13,31,4,198,1
122,13,47,3,185,1
114,24,46,2,186,1
119,36,41,0,196,1
108,35,39,0,182,1
113,18,28,1,160,1
118,36,37,0,191,1
113,35,48,3,199,1
66,7,22,30,125,1
64,12,27,8,111,0
37,5,13,11,66,0
82,17,31,20,150,1
63,5,23,12,103,0
20,12,16,24,72,0
46,5,34,9,94,0
35,9,8,29,81,0
33,9,11,21,74,0
32,9,10,30,81,0
62,10,6,22,100,0
62,10,11,22,105,0
54,10,12,25,101,0
48,8,15,23,94,0
20,10,12,24,66,0
35,10,5,30,80,0
112,15,40,10,177,1
51,21,25,13,110,0
53,12,23,8,96,0
63,22,18,15,118,0
50,23,16,8,97,0
94,20,35,17,166,1
7,27,39,17,90,0
109,18,13,6,146,0
18,27,19,6,70,0
21,30,5,5,61,0
49,16,9,12,86,0
129,28,40,6,203,1
141,18,28,8,195,1
131,14,43,7,195,1
105,38,23,5,171,1
125,35,37,5,202,1
127,36,42,9,214,1
129,22,25,9,185,1
121,39,47,8,215,1
138,29,42,9,218,1
119,26,21,5,171,1
138,17,48,8,211,1
72,12,14,32,130,1
92,23,20,30,165,1
94,17,11,24,146,1
102,25,12,24,163,1
71,23,17,14,125,0
58,5,19,25,107,0
93,22,18,10,143,0
59,23,10,35,127,1
57,20,10,20,107,0
96,9,18,25,148,1
104,12,16,20,152,0
104,22,17,23,166,1
88,8,11,29,136,1
20,3,0,16,39,0
17,2,1,30,50,0
17,4,0,23,44,0
15,5,0,21,41,0
10,0,1,31,42,0
11,1,1,19,32,0
12,2,0,29,43,0
11,0,1,11,23,0
18,4,1,28,51,0
13,3,0,26,42,0
16,3,0,34,53,0
16,4,0,35,55,0
20,2,1,33,56,0
14,4,1,28,47,0
11,4,1,19,35,0
19,4,0,17,40,0
18,3,1,26,48,0
10,1,1,21,33,0
20,5,1,40,66,0
11,5,0,37,53,0
15,4,1,29,49,0
16,2,1,27,46,0
10,3,1,23,37,0
16,5,1,31,53,0
20,0,1,30,51,0
61,4,5,17,87,0
91,8,6,2,107,0
94,4,5,2,105,0
117,8,6,16,147,0
111,14,10,14,149,0
91,2,3,5,101,0
96,9,1,16,122,0
134,15,42,5,196,1
121,35,39,4,199,1
118,40,40,3,201,1
115,17,40,1,173,1
106,22,37,0,165,1
147,26,40,0,213,1
102,13,31,2,148,1
102,12,24,3,141,0
130,40,31,2,203,1
102,17,33,0,152,1
105,13,48,5,171,1
129,24,25,0,178,1
117,11,45,0,173,1
74,14,23,21,132,1
80,14,35,18,147,1
31,7,34,24,96,0
18,15,9,15,57,0
15,10,23,20,68,0
37,18,8,16,79,0
10,7,5,14,36,0
54,6,15,23,98,0
34,7,5,24,70,0
50,7,8,21,86,0
44,9,10,24,87,0
63,8,15,24,110,0
56,6,6,29,97,0
69,5,13,27,114,1
39,5,3,30,77,0
61,10,14,24,109,0
61,30,5,20,116,0
20,17,9,5,51,0
70,22,38,7,137,1
25,30,31,9,95,0
23,13,12,6,54,0
105,30,24,8,167,0
107,10,6,6,129,0
40,20,36,7,103,0
74,18,37,11,140,1
62,15,8,11,96,0
81,20,14,12,127,0
111,32,43,5,191,1
145,12,41,6,204,1
139,11,20,7,177,1
129,40,31,10,210,1
128,22,28,8,186,1
103,17,23,8,151,0
127,32,29,7,195,1
120,35,44,8,207,1
106,11,41,7,165,1
114,40,31,5,190,1
101,13,20,7,141,0
110,25,19,34,188,1
108,6,17,23,154,1
104,12,10,10,136,0
102,22,17,23,164,1
77,19,16,8,120,0
70,16,19,33,138,1
75,9,13,28,125,1
95,9,16,29,149,1
77,17,17,22,133,1
73,16,14,34,137,1
59,7,18,12,96,0
54,20,10,9,93,0
90,6,18,32,146,1
15,5,1,32,53,0
12,1,0,11,24,0
17,2,0,28,47,0
13,5,1,12,31,0
15,5,0,21,41,0
18,4,0,11,33,0
12,4,0,21,37,0
10,4,1,12,27,0
15,2,0,25,42,0
11,0,0,24,35,0
15,2,1,15,33,0
20,3,1,29,53,0
17,2,0,24,43,0
19,5,1,26,51,0
20,3,1,32,56,0
15,3,0,19,37,0
13,5,0,17,35,0
12,5,1,19,37,0
10,2,0,27,39,0
20,4,1,23,48,0
14,0,0,16,30,0
12,4,1,28,45,0
19,2,0,20,41,0
20,2,1,19,42,0
16,0,0,36,52,0
62,20,4,18,104,0
50,13,2,14,79,0
101,3,6,6,116,0
94,15,2,9,120,0
68,10,8,1,87,0
95,3,8,20,126,0
113,7,10,16,146,0
106,13,39,1,159,1
105,32,47,4,188,1
150,19,34,4,207,1
137,38,39,2,216,1
113,11,32,1,157,1
117,30,26,5,178,1
130,10,37,1,178,1
150,32,31,1,214,1
146,10,30,3,189,1
123,24,46,2,195,1
110,24,26,4,164,1
111,33,31,2,177,1
132,18,32,2,184,1
66,16,22,13,117,0
45,24,5,23,97,0
92,19,15,7,133,0
78,22,16,25,141,1
90,2,15,18,125,0
23,2,37,9,71,0
17,5,6,20,48,0
41,5,4,24,74,0
32,5,15,26,78,0
65,7,7,22,101,0
22,6,3,25,56,0
54,7,4,28,93,0
38,5,8,28,79,0
59,7,15,23,104,0
34,8,10,23,75,0
28,6,3,27,64,0
7,16,11,14,48,0
8,12,22,8,50,0
42,25,38,18,123,1
82,13,28,5,128,1
14,24,26,9,73,0
39,25,33,9,106,0
47,14,29,6,96,0
120,20,21,18,179,1
114,11,39,10,174,1
99,24,30,10,163,1
78,18,30,8,134,1
144,40,29,10,223,0
107,28,38,9,182,1
123,28,24,10,185,1
126,15,28,6,175,1
147,28,23,5,203,1
100,21,33,7,161,1
113,12,22,6,153,0
130,34,30,6,200,1
118,40,29,10,197,1
113,38,44,9,204,1
117,29,29,9,184,1
106,12,20,32,170,1
96,11,15,14,136,0
58,11,14,24,107,0
76,22,10,9,117,0
66,6,12,33,117,1
61,23,13,18,115,0
93,6,15,17,131,0
51,11,16,26,104,0
86,6,12,9,113,0
77,15,12,29,133,1
84,15,16,8,123,0
103,12,15,10,140,0
60,9,11,27,107,0
14,1,1,22,38,0
14,2,0,35,51,0
13,1,1,31,46,0
19,0,1,22,42,0
13,4,0,28,45,0
13,1,0,26,40,0
12,0,1,34,47,0
20,1,1,38,60,0
12,3,0,38,53,0
12,1,0,40,53,0
20,5,0,10,35,0
12,4,1,27,44,0
15,5,0,21,41,0
19,2,0,30,51,0
11,0,1,40,52,0
15,3,0,35,53,0
15,0,1,37,53,0
16,2,0,37,55,0
10,0,1,24,35,0
12,0,1,31,44,0
15,1,1,36,53,0
14,5,0,17,36,0
17,3,1,38,59,0
19,0,0,18,37,0
18,5,1,30,54,0
119,12,6,4,141,0
74,28,1,13,116,0
101,26,10,0,137,0
99,4,7,19,129,0
99,18,7,5,129,0
102,24,2,8,136,0
50,4,6,13,73,0
128,11,46,4,189,1
129,39,43,0,211,1
129,27,38,0,194,1
113,24,22,2,161,0
141,15,21,5,182,1
120,22,29,1,172,1
141,24,47,4,216,1
149,24,33,1,207,1
140,40,36,1,217,1
140,20,36,0,196,1
107,13,31,4,155,1
141,15,32,4,192,1
120,27,38,4,189,1
70,14,21,5,110,0
55,24,16,21,116,1
52,18,22,16,108,0
65,4,19,21,109,0
54,10,30,28,122,1
37,3,32,18,90,0
23,3,37,18,81,0
43,7,7,29,86,0
22,6,13,24,65,0
21,10,6,30,67,0
48,8,11,22,89,0
35,5,12,20,72,0
69,5,13,22,109,0
22,9,10,21,62,0
46,5,9,23,83,0
49,5,11,21,86,0
29,18,29,20,96,0
96,23,31,14,164,1
100,27,23,16,166,0
96,22,36,5,159,1
27,26,25,15,93,0
114,21,32,5,172,1
74,27,34,10,145,1
14,16,9,14,53,0
84,30,26,10,150,1
96,19,14,18,147,0
40,15,28,5,88,0
110,15,46,5,176,1
138,39,31,7,215,1
118,32,32,10,192,1
142,34,38,9,223,0
113,13,36,5,167,0
104,29,32,7,172,1
134,39,21,9,203,1
107,15,48,5,175,1
139,25,43,7,214,1
128,20,20,6,174,1
101,13,47,10,171,1
105,17,13,23,158,1
103,14,13,9,139,0
51,23,15,13,102,0
84,10,16,20,130,0
97,25,19,24,165,1
98,8,10,19,135,0
94,13,19,25,151,1
105,25,11,35,176,1
74,9,13,6,102,0
57,18,13,28,116,1
57,14,11,33,115,1
84,23,19,15,141,0
105,14,16,33,168,1
10,4,1,38,53,0
15,1,1,29,46,0
14,1,1,25,41,0
20,2,0,37,59,0
20,1,0,27,48,0
13,1,1,18,33,0
19,0,0,35,54,0
14,1,1,27,43,0
13,5,0,12,30,0
18,5,0,12,35,0
10,3,1,32,46,0
14,2,0,15,31,0
16,3,0,15,34,0
14,2,0,25,41,0
17,5,0,18,40,0
13,1,0,28,42,0
19,0,1,20,40,0
15,4,0,40,59,0
14,3,1,26,44,0
15,4,0,14,33,0
12,3,1,13,29,0
12,4,0,31,47,0
17,4,1,20,42,0
12,0,1,13,26,0
18,2,0,16,36,0
115,16,10,13,154,0
117,5,10,15,147,0
92,26,8,7,133,0
88,3,6,4,101,0
109,11,4,3,127,0
81,4,0,20,105,0
118,2,5,19,144,0
107,26,31,2,166,1
103,11,35,5,154,1
145,13,33,3,194,1
143,22,37,4,206,1
113,38,50,3,204,1
149,10,47,3,209,1
132,33,35,2,202,1
119,40,41,2,202,1
133,31,27,2,193,1
140,20,44,4,208,1
140,34,31,1,206,1
128,37,50,2,217,1
132,11,24,3,170,1
23,8,40,27,98,0
75,2,18,29,124,1
99,14,33,14,160,1
10,1,13,7,31,0
74,21,29,26,150,1
29,15,25,5,74,0
50,17,38,24,129,1
64,9,14,20,107,0
49,5,10,21,85,0
39,7,10,30,86,0
68,5,5,24,102,0
67,7,8,22,104,0
47,8,3,25,83,0
66,9,7,24,106,0
46,8,3,22,79,0
54,6,12,21,93,0
18,16,32,18,84,0
24,20,7,9,60,0
113,17,16,20,166,0
52,13,15,10,90,0
58,26,25,18,127,0
44,19,22,6,91,0
8,26,34,9,77,0
31,10,27,8,76,0
115,24,16,5,160,0
56,29,16,16,117,0
7,12,33,12,64,0
133,10,46,10,199,1
104,31,37,6,178,1
100,38,36,9,183,1
127,25,37,5,194,1
118,32,48,6,204,1
147,19,31,8,205,1
123,36,34,5,198,1
111,24,25,5,165,0
121,16,42,8,187,1
119,38,47,7,211,1
132,30,41,6,209,1
52,6,12,18,88,0
97,21,10,8,136,0
50,16,20,31,117,1
94,25,19,8,146,0
66,11,18,34,129,1
105,16,15,6,142,0
56,23,10,18,107,0
105,19,10,25,159,1
60,18,11,16,105,0
88,10,14,11,123,0
110,6,14,23,153,1
78,20,11,35,144,1
105,14,10,7,136,0
18,1,0,10,29,0
18,1,0,27,46,0
12,4,1,18,35,0
15,4,1,32,52,0
13,4,0,32,49,0
14,4,0,15,33,0
15,4,0,17,36,0
14,0,1,21,36,0
17,5,0,37,59,0
14,4,1,12,31,0
16,2,0,15,33,0
13,4,1,14,32,0
12,4,0,29,45,0
19,4,1,30,54,0
18,4,0,18,40,0
18,1,1,12,32,0
20,4,1,21,46,0
10,2,1,20,33,0
18,5,1,23,47,0
16,5,1,30,52,0
12,3,0,40,55,0
12,2,0,40,54,0
16,0,1,37,54,0
15,4,1,16,36,0
13,0,0,38,51,0
61,5,3,14,83,0
27,15,6,10,58,0
74,11,5,15,105,0
70,6,7,14,97,0
33,6,0,11,50,0
29,12,1,13,55,0
69,5,7,10,91,0
41,16,7,15,79,0
35,11,5,11,62,0
25,9,6,14,54,0
65,15,1,11,92,0
66,6,3,14,89,0
27,6,5,15,53,0
75,6,1,10,92,0
54,11,4,12,81,0
54,18,3,12,87,0
69,8,0,14,91,0
52,19,6,10,87,0
66,8,0,12,86,0
54,11,0,13,78,0
151,48,15,3,217,1
170,62,18,2,252,1
134,59,11,3,207,1
166,63,22,1,252,1
173,64,10,2,249,1
176,45,22,2,245,1
162,59,27,1,249,1
171,46,15,3,235,1
158,44,26,2,230,1
151,64,16,0,231,1
162,65,14,3,244,1
179,44,23,1,247,1
175,59,11,3,248,1
173,63,13,2,251,1
144,66,11,3,224,1
132,68,22,4,226,1
161,50,10,0,221,1
151,56,29,1,237,1
168,59,24,1,252,1
144,65,20,3,232,1
179,63,12,2,256,1
161,56,12,4,233,1
134,67,12,1,214,1
140,70,23,4,237,1
66,29,24,1,120,0
60,27,17,2,106,0
89,27,10,2,128,0
81,29,5,0,115,0
78,22,12,1,113,0
71,24,18,2,115,0
50,26,9,1,86,0
55,28,5,0,88,0
61,20,25,1,107,0
76,22,14,2,114,0
50,20,23,1,94,0
89,26,0,2,117,0
62,20,17,0,99,0
83,20,23,2,128,0
65,20,2,0,87,0
60,21,2,1,84,0
36,8,3,9,56,0
39,5,4,11,59,0
26,8,3,0,37,0
23,4,0,5,32,0
50,2,0,4,56,0
30,2,3,1,36,0
48,10,4,2,64,0
39,6,6,1,52,0
47,10,3,9,69,0
26,3,5,3,37,0
25,6,3,9,43,0
19,1,0,11,31,0
16,5,0,26,47,0
15,2,1,39,57,0
14,5,0,11,30,0
12,2,0,20,34,0
11,2,0,35,48,0
18,5,1,11,35,0
17,2,0,20,39,0
19,5,1,30,55,0
17,4,1,24,46,0
16,3,0,14,33,0
16,3,1,23,43,0
20,0,1,17,38,0
20,0,0,37,57,0
18,0,1,30,49,0
19,1,0,14,34,0
18,5,0,29,52,0
11,1,0,22,34,0
20,3,0,24,47,0
12,2,1,10,25,0
19,5,1,31,56,0
10,0,0,32,42,0
14,1,1,12,28,0
14,2,1,24,41,0
10,3,0,32,45,0
97,23,6,17,143,0
104,22,7,11,144,0
100,15,8,20,143,0
87,7,7,4,105,0
77,27,8,10,122,0
51,7,4,5,67,0
79,1,10,6,96,0
100,40,29,5,174,1
112,13,39,0,164,1
120,16,34,2,172,1
123,14,26,3,166,1
142,27,27,4,200,1
139,38,49,2,228,1
134,24,21,2,181,1
102,13,31,0,146,1
102,16,43,4,165,1
106,16,32,1,155,1
117,19,42,3,181,1
139,36,40,3,218,1
121,13,25,2,161,0
65,19,16,11,111,0
12,25,39,28,104,0
98,21,10,5,134,0
58,9,25,13,105,0
81,10,39,29,159,1
67,20,33,29,149,1
68,22,25,16,131,0
47,10,6,22,85,0
45,7,10,27,89,0
54,5,11,24,94,0
61,7,15,28,111,0
56,5,4,29,94,0
23,5,4,27,59,0
31,6,8,23,68,0
27,7,14,28,76,0
30,7,3,30,70,0
114,21,5,14,154,0
46,24,35,16,121,1
68,29,29,20,146,1
45,16,15,5,81,0
86,13,11,20,130,0
44,11,19,15,89,0
45,17,13,20,95,0
106,17,7,12,142,0
44,16,9,13,82,0
77,23,13,9,122,0
53,17,26,8,104,0
138,18,20,8,184,1
142,24,39,9,214,1
114,25,21,7,167,0
116,35,42,6,199,1
149,22,37,8,216,1
100,12,39,7,158,1
101,23,45,5,174,1
122,40,48,10,220,1
112,34,39,9,194,1
112,12,41,5,170,1
116,22,23,7,168,1
90,13,15,33,151,1
85,14,14,13,126,0
59,25,13,27,124,1
108,5,15,22,150,1
75,8,16,25,124,1
96,15,12,27,150,1
61,17,10,8,96,0
84,25,20,30,159,1
55,9,12,19,95,0
65,16,12,32,125,1
87,16,10,16,129,0
75,5,12,21,113,1
82,16,14,34,146,1
11,3,0,34,48,0
15,5,0,14,34,0
18,5,1,13,37,0
19,2,1,34,56,0
20,4,1,26,51,0
14,4,0,10,28,0
11,1,1,36,49,0
10,2,1,15,28,0
10,3,0,33,46,0
14,3,0,23,40,0
11,5,1,11,28,0
10,1,1,34,46,0
20,4,1,17,42,0
17,5,0,24,46,0
12,2,1,18,33,0
15,0,1,16,32,0
19,5,0,15,39,0
11,3,1,39,54,0
14,5,0,10,29,0
20,0,1,33,54,0
13,1,1,33,48,0
18,2,1,12,33,0
19,2,1,23,45,0
10,4,0,36,50,0
13,4,0,17,34,0
86,28,2,18,134,0
59,29,9,14,111,0
102,20,9,13,144,0
114,28,8,16,166,0
87,23,5,0,115,0
88,5,8,13,114,0
83,6,4,9,102,0
150,19,24,3,196,1
148,35,46,1,230,1
146,23,23,4,196,1
140,21,39,3,203,1
149,36,35,1,221,1
125,34,42,0,201,1
147,34,20,5,206,1
128,33,21,4,186,1
111,38,50,5,204,1
144,20,32,4,200,1
121,14,23,1,159,0
136,36,40,4,216,1
114,21,23,1,159,0
75,17,37,29,158,1
34,5,27,22,88,0
45,6,7,15,73,0
65,10,6,27,108,0
67,25,20,18,130,0
50,25,25,28,128,1
37,19,38,12,106,0
36,8,3,29,76,0
63,5,8,23,99,0
67,5,7,22,101,0
36,9,14,22,81,0
57,8,10,22,97,0
65,7,14,25,111,0
54,10,3,29,96,0
41,5,4,25,75,0
43,9,3,25,80,0
9,27,32,17,85,0
101,28,18,20,167,0
99,16,16,18,149,0
20,27,32,12,91,0
96,16,39,17,168,1
62,28,18,20,128,0
58,27,17,5,107,0
60,18,28,12,118,1
81,26,13,17,137,0
118,15,27,13,173,1
53,12,25,20,110,0
132,12,27,9,180,1
149,14,50,5,218,1
106,35,41,5,187,1
150,29,27,7,213,1
110,30,46,5,191,1
129,35,34,5,203,1
133,21,26,5,185,1
148,34,45,7,234,1
144,39,43,8,234,1
126,27,44,8,205,1
103,34,49,5,191,1
96,7,13,30,146,1
54,17,17,19,107,0
98,16,17,15,146,0
72,6,19,8,105,0
69,23,12,31,135,1
85,13,16,24,138,1
102,22,12,9,145,0
103,14,20,14,151,0
80,12,10,22,124,1
63,18,11,5,97,0
84,21,13,9,127,0
72,10,10,29,121,1
79,22,17,13,131,0
12,5,0,27,44,0
19,1,1,38,59,0
14,3,0,33,50,0
16,3,1,37,57,0
14,5,0,37,56,0
11,2,1,20,34,0
20,3,0,25,48,0
20,0,1,30,51,0
13,2,1,17,33,0
20,1,1,19,41,0
10,2,1,12,25,0
14,2,0,25,41,0
12,0,1,16,29,0
11,5,1,31,48,0
13,1,1,16,31,0
17,3,0,10,30,0
11,1,0,22,34,0
10,4,1,16,31,0
15,3,1,32,51,0
10,0,0,22,32,0
20,1,1,16,38,0
16,1,1,15,33,0
14,4,1,32,51,0
16,1,1,37,55,0
10,2,1,36,49,0
96,18,7,2,123,0
51,14,0,5,70,0
63,25,2,8,98,0
72,7,1,4,84,0
86,18,6,1,111,0
105,4,4,20,133,0
117,10,10,18,155,0
120,36,32,0,188,1
135,20,31,0,186,1
112,40,42,3,197,1
135,13,20,3,171,1
105,35,24,2,166,0
150,25,36,0,211,1
108,27,23,2,160,0
108,40,45,1,194,1
118,19,21,1,159,0
131,18,41,1,191,1
148,31,20,4,203,1
120,26,22,1,169,1
147,12,32,0,191,1
73,9,35,12,129,1
93,21,22,29,165,1
66,2,10,28,106,0
18,6,6,6,36,0
78,1,16,30,125,1
69,15,24,20,128,0
82,2,40,17,141,1
57,9,5,23,94,0
25,5,14,26,70,0
40,9,15,28,92,0
52,6,13,21,92,0
45,8,13,29,95,0
67,10,7,25,109,0
20,8,14,30,72,0
44,8,4,29,85,0
63,5,8,29,105,0
119,15,20,13,167,0
103,10,23,7,143,0
42,14,15,14,85,0
67,20,24,12,123,0
56,18,29,17,120,1
65,16,32,15,128,1
107,11,26,19,163,1
11,18,22,10,61,0
28,15,27,12,82,0
45,17,7,6,75,0
66,12,27,6,111,0
104,40,22,9,175,1
113,21,26,5,165,1
120,29,37,6,192,1
129,10,39,6,184,1
119,29,40,10,198,1
119,25,32,9,185,1
123,10,30,7,170,1
111,33,28,5,177,1
110,12,47,8,177,1
139,15,43,9,206,1
132,29,25,7,193,1
51,8,18,18,95,0
76,5,14,20,115,0
53,15,13,23,104,0
50,25,19,9,103,0
86,24,20,34,164,1
67,23,14,13,117,0
54,9,15,7,85,0
59,12,16,35,122,1
109,25,15,5,154,0
73,18,10,35,136,1
65,24,14,19,122,0
94,10,11,22,137,1
106,9,12,31,158,1
18,3,0,11,32,0
17,1,1,36,55,0
12,0,0,22,34,0
11,1,0,19,31,0
16,1,0,32,49,0
12,3,1,13,29,0
14,4,1,27,46,0
11,3,1,37,52,0
17,2,0,18,37,0
18,4,1,39,62,0
20,4,0,32,56,0
15,0,0,28,43,0
11,4,0,12,27,0
19,5,1,35,60,0
15,0,1,26,42,0
11,4,0,31,46,0
19,2,1,33,55,0
12,4,1,29,46,0
15,5,1,16,37,0
14,4,1,21,40,0
19,4,1,17,41,0
10,2,1,12,25,0
10,0,0,11,21,0
20,4,1,33,58,0
10,1,0,12,23,0
73,12,5,5,95,0
95,15,4,19,133,0
81,19,3,13,116,0
119,25,10,9,163,0
80,10,4,15,109,0
102,24,3,16,145,0
68,17,6,10,101,0
109,40,38,0,187,1
124,25,31,1,181,1
126,22,21,1,170,1
120,31,29,5,185,1
101,20,47,5,173,1
139,40,48,2,229,1
116,23,23,4,166,0
101,14,24,0,139,0
137,40,21,5,203,1
131,26,36,0,193,1
114,27,45,4,190,1
102,14,46,1,163,1
116,24,32,5,177,1
29,10,21,12,72,0
41,12,15,10,78,0
41,9,7,27,84,0
90,25,26,10,151,1
64,25,17,20,126,0
64,10,17,23,114,1
69,17,5,28,119,1
59,9,9,21,98,0
44,10,12,29,95,0
43,5,6,26,80,0
65,7,10,21,103,0
29,5,12,21,67,0
24,9,8,20,61,0
44,6,4,26,80,0
35,10,12,24,81,0
43,10,15,21,89,0
45,17,24,11,97,0
108,21,37,14,180,1
53,19,33,9,114,1
75,23,31,13,142,1
70,18,5,19,112,0
52,25,15,19,111,0
9,18,24,9,60,0
47,21,9,18,95,0
116,20,17,19,172,1
65,14,6,9,94,0
93,12,13,13,131,0
100,21,45,9,175,1
121,24,31,6,182,1
110,15,50,5,180,1
103,17,28,5,153,1
136,38,20,5,199,1
119,22,32,9,182,1
132,17,36,5,190,1
147,10,41,5,203,1
111,12,44,6,173,1
102,27,32,5,166,1
137,25,29,7,198,1
71,17,15,31,134,1
64,25,11,15,115,0
70,16,15,29,130,1
91,9,11,32,143,1
95,6,11,35,147,1
76,16,10,31,133,1
87,17,18,7,129,0
63,22,12,29,126,1
56,17,20,8,101,0
102,18,19,29,168,1
60,23,10,13,106,0
88,6,18,25,137,1
104,15,10,32,161,1
16,1,1,26,44,0
12,1,0,12,25,0
16,1,0,29,46,0
13,5,0,31,49,0
20,1,1,27,49,0
18,0,0,29,47,0
16,3,1,26,46,0
18,0,0,21,39,0
11,5,0,24,40,0
13,1,0,10,24,0
10,1,0,26,37,0
19,5,1,22,47,0
20,0,0,10,30,0
16,4,1,39,60,0
19,1,1,11,32,0
20,4,0,38,62,0
15,1,1,15,32,0
10,0,0,33,43,0
20,5,0,24,49,0
12,2,1,35,50,0
10,4,1,37,52,0
15,4,0,38,57,0
19,0,1,39,59,0
16,4,0,35,55,0
20,3,1,35,59,0
118,1,0,4,123,0
89,20,4,17,130,0
120,18,6,13,157,0
85,7,3,18,113,0
99,8,2,14,123,0
59,25,2,7,93,0
58,25,2,5,90,0
113,40,36,4,193,1
113,16,50,2,181,1
121,27,50,4,202,1
150,17,28,0,195,1
136,29,23,0,188,1
142,32,27,2,203,1
106,32,42,2,182,1
103,21,20,0,144,0
131,19,26,1,177,1
133,23,21,3,180,1
123,17,50,1,191,1
124,21,35,2,182,1
136,26,20,4,186,1
92,10,39,19,160,1
82,7,13,19,121,0
42,2,28,27,99,0
24,17,17,9,67,0
42,19,17,12,90,0
100,12,5,23,140,1
11,25,30,22,88,0
27,7,10,22,66,0
38,7,11,20,76,0
49,10,6,27,92,0
66,9,7,28,110,0
70,8,3,22,103,0
58,7,6,27,98,0
53,9,13,29,104,0
22,5,6,26,59,0
40,10,11,28,89,0
58,13,10,12,93,0
60,25,24,17,126,0
25,11,24,17,77,0
22,28,11,18,79,0
6,11,37,15,69,0
92,18,34,18,162,1
97,17,38,20,172,1
92,18,31,6,147,1
74,12,17,16,119,0
67,22,7,5,101,0
84,20,25,15,144,0
144,15,42,8,209,1
120,11,47,7,185,1
108,10,36,6,160,1
141,13,50,6,210,1
121,37,29,8,195,1
142,40,22,6,210,1
137,23,28,7,195,1
117,10,27,8,162,1
100,16,37,7,160,1
148,11,42,8,209,1
148,27,39,6,220,1
65,18,20,21,124,1
75,9,14,6,104,0
85,15,20,29,149,1
57,21,20,18,116,0
50,7,13,30,100,0
87,21,14,34,156,1
64,24,11,6,105,0
76,6,18,14,114,0
69,11,12,8,100,0
76,9,17,14,116,0
94,8,15,5,122,0
104,10,16,33,163,1
98,13,13,33,157,1
13,5,0,18,36,0
17,1,0,11,29,0
18,2,1,34,55,0
11,1,0,35,47,0
17,4,0,11,32,0
17,1,1,23,42,0
17,2,0,23,42,0
16,4,1,30,51,0
15,5,1,23,44,0
18,0,0,31,49,0
10,1,0,17,28,0
13,2,0,32,47,0
16,1,0,38,55,0
11,4,0,32,47,0
12,2,0,26,40,0
14,2,1,14,31,0
18,2,0,37,57,0
17,1,1,22,41,0
12,3,0,29,44,0
20,5,0,30,55,0
17,5,1,19,42,0
12,0,1,33,46,0
19,1,0,20,40,0
11,4,1,38,54,0
14,5,0,39,58,0
102,20,4,12,138,0
92,4,6,18,120,0
54,14,10,16,94,0
55,15,1,10,81,0
64,27,5,5,101,0
52,13,5,15,85,0
73,11,4,3,91,0
106,27,45,5,183,1
145,21,40,5,211,1
133,19,28,5,185,1
117,31,49,0,197,1
146,17,34,0,197,1
101,35,42,3,181,1
103,28,32,1,164,1
150,10,26,0,186,1
135,23,48,0,206,1
104,10,48,2,164,1
144,39,50,1,234,1
132,10,49,0,191,1
142,19,31,1,193,1
45,4,30,29,108,0
27,24,10,5,66,0
85,3,14,16,118,0
84,11,27,26,148,1
90,4,10,20,124,0
13,19,39,12,83,0
11,1,37,9,58,0
57,10,4,27,98,0
52,10,9,23,94,0
38,7,13,21,79,0
35,7,15,24,81,0
60,10,12,21,103,0
70,10,3,30,113,1
34,8,6,30,78,0
44,6,4,27,81,0
21,5,4,25,55,0
106,10,11,11,138,0
82,30,32,10,154,1
57,12,9,17,95,0
60,18,21,10,109,0
79,17,34,8,138,1
78,29,22,13,142,0
69,14,32,18,133,1
84,25,5,9,123,0
62,11,28,5,106,0
33,17,22,18,90,0
14,21,23,6,64,0
127,27,40,5,199,1
136,10,27,7,180,1
148,14,37,9,208,1
122,16,28,6,172,1
132,12,45,9,198,1
136,29,29,10,204,1
103,33,48,10,194,1
132,37,23,10,202,1
136,39,39,6,220,1
120,24,36,5,185,1
126,34,38,9,207,1
80,22,14,18,134,0
99,9,15,29,152,1
81,21,19,7,128,0
87,9,16,26,138,1
80,17,13,30,140,1
91,18,18,9,136,0
90,19,15,13,137,0
107,19,10,23,159,1
98,11,14,27,150,1
98,18,20,22,158,1
102,5,12,17,136,0
62,13,16,28,119,1
101,15,12,35,163,1
17,5,1,16,39,0
10,4,1,37,52,0
16,4,0,35,55,0
17,2,0,17,36,0
17,0,0,27,44,0
17,4,1,25,47,0
15,2,0,15,32,0
20,0,1,12,33,0
16,3,0,28,47,0
13,2,1,28,44,0
15,5,0,26,46,0
15,2,1,16,34,0
12,3,0,26,41,0
15,5,0,27,47,0
20,2,0,17,39,0
12,2,0,16,30,0
19,1,0,38,58,0
16,1,1,32,50,0
12,0,0,11,23,0
16,5,1,29,51,0
19,5,1,18,43,0
11,0,0,15,26,0
15,4,1,17,37,0
20,1,0,23,44,0
10,4,0,36,50,0
39,14,0,15,68,0
33,7,3,10,53,0
77,8,7,15,107,0
80,18,6,11,115,0
53,11,7,15,86,0
73,17,6,13,109,0
77,20,4,13,114,0
76,14,1,12,103,0
58,14,0,15,87,0
57,18,7,13,95,0
80,16,0,10,106,0
38,7,1,13,59,0
53,20,6,12,91,0
30,9,7,10,56,0
50,19,4,10,83,0
31,14,3,14,62,0
28,18,5,10,61,0
31,15,4,12,62,0
52,19,0,10,81,0
42,9,2,13,66,0
151,55,27,2,235,1
180,69,29,1,279,1
149,41,23,3,216,1
167,60,27,3,257,1
134,45,22,3,204,1
180,62,26,4,272,1
156,54,25,3,238,1
171,60,18,1,250,1
174,53,10,3,240,1
154,61,16,3,234,1
161,53,11,1,226,1
148,48,13,2,211,1
136,60,27,2,225,1
143,68,16,0,227,1
152,51,22,2,227,1
132,58,15,4,209,1
155,58,15,4,232,1
144,62,12,3,221,1
161,51,20,1,233,1
137,46,13,2,198,1
149,61,16,1,227,1
158,46,20,1,225,1
134,65,22,0,221,1
134,65,10,2,211,1
73,24,4,0,101,0
64,23,21,1,109,0
51,27,25,2,105,0
80,22,17,0,119,0
61,26,8,0,95,0
75,24,8,0,107,0
82,20,15,2,119,0
53,28,21,1,103,0
68,29,14,0,111,0
63,28,22,0,113,0
76,30,20,1,127,0
66,23,10,0,99,0
50,23,1,0,74,0
60,29,22,2,113,0
75,26,11,0,112,0
81,22,18,2,123,0
33,6,0,4,43,0
21,5,6,15,47,0
22,7,1,2,32,0
31,6,0,15,52,0
41,8,3,2,54,0
24,6,5,11,46,0
45,6,6,10,67,0
24,11,6,2,43,0
47,6,2,12,67,0
46,1,1,4,52,0
26,3,2,3,34,0
20,4,0,39,63,0
20,1,1,27,49,0
19,0,1,17,37,0
11,3,1,19,34,0
17,5,1,31,54,0
19,4,0,12,35,0
11,1,0,38,50,0
12,0,0,17,29,0
18,0,0,27,45,0
19,4,0,14,37,0
13,2,0,28,43,0
18,4,1,23,46,0
20,0,0,11,31,0
11,4,1,22,38,0
15,2,0,18,35,0
16,3,0,34,53,0
11,2,0,18,31,0
17,4,1,38,60,0
20,4,1,28,53,0
19,0,1,37,57,0
10,2,1,34,47,0
19,0,0,17,36,0
15,0,0,30,45,0
10,2,0,31,43,0
18,3,0,17,38,0
97,22,4,18,141,0
111,12,9,17,149,0
108,10,5,17,140,0
74,24,10,20,128,0
114,4,8,20,146,0
91,16,5,11,123,0
66,3,9,19,97,0
104,32,23,5,164,0
128,18,31,3,180,1
127,24,27,0,178,1
130,31,22,0,183,1
108,13,38,1,160,1
116,22,37,2,177,1
143,28,27,4,202,1
118,32,21,5,176,1
121,35,32,0,188,1
109,28,39,2,178,1
135,11,23,5,174,1
100,30,29,2,161,1
138,32,26,4,200,1
29,9,21,23,82,0
36,17,7,30,90,0
42,9,37,28,116,1
80,6,12,6,104,0
37,21,28,6,92,0
44,17,27,30,118,1
25,12,13,5,55,0
36,9,9,30,84,0
63,7,10,29,109,0
20,5,13,22,60,0
53,8,6,23,90,0
41,7,5,26,79,0
36,9,13,29,87,0
65,10,8,22,105,0
55,6,5,27,93,0
63,8,15,30,116,1
19,26,32,18,95,0
84,11,11,9,115,0
110,23,34,9,176,1
46,20,18,5,89,0
67,12,10,20,109,0
42,25,20,19,106,0
87,17,18,6,128,0
45,24,31,11,111,0
80,26,35,6,147,1
83,18,6,15,122,0
68,19,15,11,113,0
101,37,48,9,195,1
149,32,29,10,220,1
136,21,33,9,199,1
105,20,23,7,155,0
125,12,20,8,165,0
125,14,26,5,170,1
118,28,23,8,177,1
114,32,45,6,197,1
123,37,46,8,214,1
115,23,22,7,167,0
111,25,35,10,181,1
66,8,11,9,94,0
103,12,17,23,155,1
94,14,14,24,146,1
105,23,15,18,161,0
53,22,14,35,124,1
74,10,12,32,128,1
71,24,15,26,136,1
61,21,15,32,129,1
101,25,18,8,152,0
104,22,10,14,150,0
79,20,15,18,132,0
70,20,11,14,115,0
74,16,14,34,138,1
20,5,0,21,46,0
16,0,0,36,52,0
14,3,0,20,37,0
14,1,1,30,46,0
17,0,1,12,30,0
14,0,0,14,28,0
18,5,0,40,63,0
17,2,0,18,37,0
14,1,1,35,51,0
14,2,1,26,43,0
16,0,1,37,54,0
14,4,1,32,51,0
19,5,0,12,36,0
11,0,1,31,43,0
12,0,0,32,44,0
12,3,0,32,47,0
18,4,1,31,54,0
17,4,1,20,42,0
17,0,0,22,39,0
19,2,1,12,34,0
18,2,1,19,40,0
19,5,0,26,50,0
19,5,1,35,60,0
18,0,0,20,38,0
16,0,0,30,46,0
114,30,9,7,160,0
102,17,2,14,135,0
55,4,7,13,79,0
82,2,4,14,102,0
66,16,9,19,110,0
86,5,1,13,105,0
108,24,2,19,153,0
112,30,26,0,168,1
147,31,46,0,224,1
116,20,40,2,178,1
138,13,21,5,177,1
132,25,40,2,199,1
124,14,31,4,173,1
106,27,25,1,159,0
104,24,29,5,162,1
140,31,21,4,196,1
121,35,37,3,196,1
135,23,37,5,200,1
149,20,30,5,204,1
117,14,39,0,170,1
39,8,23,13,83,0
40,14,18,21,93,0
49,1,35,18,103,0
38,12,35,25,110,0
26,15,25,6,72,0
93,14,10,25,142,1
54,24,37,20,135,1
32,6,10,23,71,0
43,7,12,23,85,0
23,6,15,20,64,0
26,5,8,25,64,0
55,7,8,27,97,0
70,10,8,25,113,1
66,10,3,29,108,0
66,7,15,26,114,1
46,6,7,21,80,0
47,26,6,20,99,0
75,20,7,11,113,0
76,29,15,19,139,0
56,14,38,12,120,1
19,26,36,17,98,0
29,18,10,9,66,0
15,12,18,15,60,0
53,27,27,17,124,1
95,22,28,9,154,1
27,27,32,10,96,0
68,28,31,15,142,1
120,14,25,8,167,0
144,28,24,8,204,1
112,31,43,8,194,1
149,28,20,10,207,1
131,29,34,8,202,1
104,31,41,9,185,1
141,30,27,7,205,1
117,10,47,9,183,1
112,13,37,6,168,1
127,40,39,8,214,1
131,15,31,6,183,1
66,8,10,11,95,0
61,23,18,34,136,1
55,25,13,26,119,1
85,23,20,6,134,0
75,20,19,19,133,0
58,17,20,22,117,1
60,23,11,26,120,1
80,21,11,7,119,0
74,9,14,35,132,1
57,14,11,16,98,0
73,9,13,5,100,0
80,25,19,26,150,1
82,13,12,21,128,1
15,4,0,27,46,0
20,2,0,29,51,0
12,2,0,39,53,0
10,4,1,13,28,0
16,0,1,29,46,0
18,0,0,34,52,0
11,5,1,19,36,0
16,1,0,12,29,0
13,3,1,12,29,0
19,2,0,22,43,0
13,3,0,39,55,0
12,0,0,24,36,0
10,3,1,12,26,0
11,4,0,38,53,0
18,4,0,31,53,0
19,1,0,34,54,0
18,1,0,27,46,0
13,0,0,26,39,0
12,2,0,35,49,0
15,4,0,12,31,0
10,5,0,33,48,0
14,0,0,15,29,0
16,0,0,16,32,0
15,3,1,26,45,0
20,4,0,34,58,0
82,20,10,11,123,0
99,7,3,6,115,0
74,29,9,4,116,0
94,1,1,14,110,0
63,12,10,17,102,0
101,4,3,12,120,0
106,9,3,10,128,0
112,15,24,1,152,0
148,26,25,0,199,1
115,20,31,3,169,1
125,11,24,0,160,0
140,38,38,0,216,1
150,17,35,5,207,1
149,11,42,2,204,1
150,22,38,3,213,1
147,32,25,4,208,1
138,39,45,4,226,1
149,16,49,1,215,1
139,10,50,2,201,1
109,25,49,2,185,1
84,24,12,28,148,1
38,8,6,5,57,0
45,16,6,21,88,0
57,4,36,14,111,0
84,12,6,28,130,1
55,25,33,21,134,1
14,15,5,21,55,0
26,8,11,20,65,0
60,10,9,27,106,0
34,6,7,25,72,0
22,9,8,26,65,0
59,10,11,30,110,0
48,6,14,28,96,0
46,9,11,23,89,0
37,9,8,20,74,0
67,9,11,21,108,0
32,19,39,9,99,0
63,12,22,5,102,0
32,29,25,11,97,0
83,22,40,20,165,1
40,14,31,19,104,0
101,22,39,19,181,1
62,29,31,11,133,1
20,19,25,8,72,0
42,22,5,9,78,0
37,17,12,16,82,0
95,12,20,15,142,0
137,14,41,10,202,1
122,21,20,10,173,1
104,19,39,9,171,1
147,21,40,9,217,1
105,38,34,7,184,1
124,23,46,5,198,1
135,18,20,5,178,1
107,35,23,8,173,1
109,21,24,10,164,0
136,32,26,8,202,1
134,23,49,8,214,1
90,20,11,25,146,1
104,5,16,16,141,0
60,21,13,6,100,0
104,22,11,13,150,0
54,23,10,25,112,1
68,6,15,34,123,1
88,13,19,19,139,0
64,22,16,16,118,0
58,24,14,24,120,1
67,19,12,9,107,0
73,20,18,7,118,0
109,25,16,20,170,1
63,15,11,23,112,1
19,4,1,26,50,0
15,1,0,34,50,0
15,5,1,14,35,0
19,3,1,33,56,0
18,4,0,11,33,0
14,1,0,27,42,0
19,0,0,37,56,0
19,0,0,29,48,0
18,1,0,30,49,0
19,3,0,18,40,0
15,2,1,34,52,0
17,0,1,14,32,0
12,0,0,33,45,0
20,0,1,20,41,0
10,2,0,18,30,0
13,3,0,31,47,0
10,0,1,38,49,0
19,1,1,28,49,0
19,4,0,16,39,0
16,1,0,15,32,0
17,1,0,34,52,0
19,1,0,21,41,0
10,1,0,39,50,0
16,4,0,15,35,0
13,0,0,16,29,0
98,5,1,17,121,0
65,10,3,8,86,0
98,17,0,20,135,0
60,20,5,6,91,0
110,18,10,11,149,0
70,13,4,13,100,0
96,12,7,17,132,0
129,31,36,1,197,1
146,28,47,3,224,1
137,23,27,0,187,1
131,28,24,0,183,1
134,10,44,0,188,1
109,25,24,0,158,0
108,35,22,3,168,1
146,14,37,2,199,1
147,21,41,5,214,1
110,34,35,0,179,1
110,40,50,2,202,1
123,12,22,3,160,0
145,25,20,5,195,1
82,15,16,29,142,1
62,2,7,22,93,0
92,8,11,21,132,1
35,22,22,18,97,0
66,25,13,13,117,0
50,2,25,12,89,0
50,22,24,7,103,0
50,8,5,24,87,0
55,5,5,21,86,0
51,10,14,24,99,0
34,8,14,21,77,0
25,7,5,20,57,0
59,7,9,21,96,0
38,10,9,24,81,0
70,10,9,23,112,1
63,8,13,22,106,0
6,24,12,13,55,0
108,17,16,16,157,0
41,20,32,12,105,0
54,10,20,9,93,0
60,19,14,7,100,0
102,11,9,11,133,0
50,24,30,5,109,0
25,24,19,10,78,0
90,25,18,20,153,0
86,13,27,11,137,1
44,19,17,9,89,0
126,24,35,8,193,1
146,26,42,9,223,0
117,28,33,10,188,1
144,36,49,10,239,1
137,19,23,9,188,1
118,19,48,5,190,1
119,27,28,8,182,1
149,26,43,5,223,0
117,34,36,10,197,1
124,30,44,10,208,1
141,36,48,5,230,1
78,6,11,28,123,1
102,23,16,24,165,1
104,18,18,23,163,1
95,9,19,7,130,0
105,13,12,20,150,0
100,18,16,34,168,1
80,14,20,15,129,0
86,8,19,7,120,0
108,20,14,15,157,0
69,13,13,8,103,0
64,14,10,6,94,0
71,14,17,10,112,0
61,9,18,24,112,1
11,4,0,31,46,0
17,5,0,14,36,0
15,5,0,18,38,0
14,2,0,40,56,0
12,2,1,28,43,0
18,0,1,40,59,0
14,5,0,13,32,0
18,1,0,26,45,0
14,0,0,34,48,0
17,5,0,23,45,0
19,1,1,18,39,0
15,5,1,12,33,0
13,2,1,26,42,0
15,3,0,32,50,0
15,0,1,13,29,0
18,5,1,12,36,0
17,1,0,29,47,0
10,4,0,19,33,0
15,0,0,18,33,0
11,0,0,35,46,0
20,5,1,34,60,0
15,5,1,32,53,0
16,4,1,37,58,0
14,1,0,12,27,0
16,4,0,18,38,0
56,21,3,0,80,0
78,11,10,18,117,0
82,29,0,20,131,0
102,15,2,7,126,0
69,14,6,18,107,0
87,24,6,19,136,0
84,16,10,5,115,0
109,38,34,5,186,1
147,38,23,3,211,1
135,19,48,5,207,1
101,23,41,5,170,1
138,21,28,1,188,1
136,20,32,1,189,1
123,19,25,5,172,1
108,30,46,5,189,1
128,15,43,5,191,1
129,37,41,1,208,1
127,18,28,3,176,1
142,37,46,3,228,1
149,26,46,1,222,1
77,13,7,23,120,1
37,16,13,29,95,0
79,8,16,12,115,0
97,2,16,7,122,0
22,8,31,8,69,0
31,23,19,12,85,0
49,22,16,5,92,0
32,5,3,21,61,0
40,6,11,28,85,0
42,6,10,21,79,0
37,9,7,25,78,0
45,5,5,24,79,0
64,10,4,28,106,0
33,8,6,23,70,0
34,6,12,27,79,0
40,9,5,20,74,0
64,19,22,12,117,0
108,24,34,7,173,1
108,17,33,7,165,1
50,23,21,11,105,0
16,21,10,16,63,0
91,22,34,8,155,1
89,19,37,18,163,1
108,12,23,8,151,0
73,29,23,7,132,0
76,28,39,14,157,1
19,15,20,17,71,0
102,37,48,9,196,1
115,36,41,8,200,1
142,23,23,6,194,1
134,15,29,8,186,1
146,18,49,9,222,1
126,24,48,9,207,1
138,18,27,6,189,1
129,13,43,6,191,1
127,35,23,10,195,1
144,20,22,7,193,1
117,19,31,7,174,1
87,10,13,16,126,0
87,6,18,30,141,1
97,18,10,24,149,1
71,21,14,12,118,0
96,24,18,10,148,0
90,7,17,31,145,1
74,6,12,34,126,1
59,7,15,20,101,0
87,11,16,28,142,1
62,22,20,20,124,0
71,16,14,9,110,0
98,9,15,18,140,0
93,8,10,16,127,0
17,4,0,36,57,0
16,1,1,29,47,0
15,2,0,10,27,0
10,3,1,23,37,0
12,4,0,31,47,0
20,1,1,24,46,0
11,0,1,23,35,0
14,1,1,17,33,0
12,5,1,38,56,0
15,4,1,29,49,0
12,4,0,40,56,0
11,5,0,22,38,0
14,5,1,21,41,0
14,3,0,39,56,0
10,4,1,11,26,0
11,0,0,16,27,0
12,3,0,39,54,0
11,0,1,36,48,0
16,2,0,35,53,0
17,3,1,36,57,0
13,1,1,13,28,0
14,5,0,19,38,0
17,5,1,15,38,0
19,3,0,13,35,0
19,3,1,12,35,0
54,15,10,8,87,0
107,0,1,2,110,0
116,20,5,14,155,0
78,2,4,9,93,0
111,22,0,12,145,0
85,27,7,17,136,0
95,5,9,20,129,0
143,33,27,1,204,1
133,40,37,0,210,1
123,37,34,4,198,1
133,34,36,1,204,1
101,20,42,4,167,0
145,10,37,0,192,1
141,39,40,5,225,1
134,12,22,2,170,1
126,10,26,4,166,1
136,22,31,0,189,1
128,26,42,4,200,1
106,12,28,4,150,1
140,27,36,2,205,1
40,20,37,28,125,1
13,25,33,12,83,0
18,22,26,10,76,0
59,5,36,12,112,1
48,9,30,14,101,0
77,23,14,20,134,0
17,13,13,27,70,0
36,5,14,25,80,0
60,10,3,28,101,0
34,5,4,29,72,0
63,5,6,20,94,0
48,10,13,23,94,0
44,5,5,21,75,0
62,5,14,23,104,0
38,8,15,27,88,0
26,6,9,29,70,0
78,23,16,13,130,0
116,21,22,17,176,1
94,13,11,16,134,0
52,19,26,10,107,0
70,13,12,10,105,0
34,17,21,14,86,0
16,18,40,6,80,0
24,20,15,17,76,0
21,15,33,12,81,0
100,10,18,7,135,0
117,22,11,5,155,0
145,30,40,8,223,0
113,38,45,7,203,1
110,31,37,7,185,1
126,15,26,6,173,1
100,15,29,7,151,1
147,28,29,10,214,1
146,22,50,10,228,1
148,23,27,5,203,1
149,17,41,9,216,1
136,32,41,7,216,1
101,22,33,9,165,1
87,18,13,34,152,1
50,21,14,9,94,0
63,23,19,34,139,1
73,9,11,5,98,0
78,13,20,25,136,1
71,22,12,14,119,0
80,17,11,15,123,0
62,21,10,35,128,1
100,17,16,33,166,1
95,15,18,9,137,0
102,14,15,34,165,1
68,12,15,32,127,1
74,5,19,5,103,0
15,4,1,21,41,0
16,0,1,24,41,0
12,0,0,12,24,0
12,5,0,23,40,0
15,2,1,14,32,0
10,3,0,23,36,0
16,2,0,35,53,0
13,3,0,22,38,0
13,0,0,32,45,0
11,1,0,27,39,0
17,1,0,32,50,0
11,2,0,17,30,0
14,1,1,11,27,0
17,2,0,33,52,0
15,2,1,38,56,0
13,4,1,24,42,0
11,5,1,11,28,0
12,3,0,22,37,0
15,1,0,26,42,0
13,0,1,34,48,0
17,5,0,15,37,0
20,3,1,26,50,0
18,4,0,30,52,0
12,1,1,19,33,0
20,0,0,12,32,0
29,10,0,12,51,0
39,20,1,10,70,0
76,9,7,13,105,0
33,17,0,13,63,0
64,14,1,12,91,0
44,7,1,11,63,0
53,8,4,15,80,0
75,6,7,13,101,0
60,11,4,10,85,0
35,14,2,14,65,0
75,20,6,15,116,0
27,10,2,12,51,0
61,20,7,14,102,0
72,20,5,15,112,0
43,18,6,14,81,0
54,10,4,14,82,0
30,12,1,14,57,0
72,8,6,12,98,0
55,17,7,15,94,0
36,20,0,13,69,0
168,55,10,0,233,1
135,61,28,2,226,1
168,68,27,2,265,1
139,44,16,1,200,1
156,63,12,3,234,1
141,51,27,3,222,1
144,44,16,3,207,1
132,65,23,0,220,1
180,48,17,2,247,1
140,67,20,4,231,1
163,62,12,0,237,1
148,70,15,0,233,1
134,47,22,3,206,1
162,51,13,0,226,1
136,49,15,1,201,1
147,52,26,0,225,1
174,54,25,1,254,1
135,69,20,1,225,1
142,55,21,1,219,1
144,59,14,2,219,1
180,49,17,0,246,1
153,59,20,4,236,1
139,43,27,3,212,1
179,60,12,0,251,1
76,21,6,1,104,0
59,25,19,1,104,0
51,20,12,1,84,0
78,24,19,2,123,0
50,24,11,0,85,0
59,25,8,0,92,0
90,21,0,0,111,0
79,26,21,2,128,0
56,21,4,1,82,0
70,25,11,2,108,0
54,27,21,2,104,0
53,22,13,2,90,0
59,27,5,2,93,0
63,30,21,0,114,0
87,21,16,0,124,0
71,26,19,1,117,0
32,5,5,13,55,0
36,6,7,2,51,0
35,10,0,2,47,0
40,10,5,10,65,0
44,6,1,3,54,0
40,6,1,3,50,0
45,2,7,7,61,0
44,2,6,5,57,0
33,4,4,5,46,0
22,5,3,13,43,0
33,5,5,1,44,0
10,0,0,29,39,0
19,3,1,35,58,0
10,4,0,30,44,0
12,3,1,25,41,0
12,1,0,40,53,0
20,2,0,19,41,0
18,4,1,11,34,0
19,1,1,37,58,0
13,2,0,25,40,0
16,4,1,15,36,0
10,4,1,16,31,0
18,3,0,19,40,0
15,5,0,10,30,0
14,2,1,22,39,0
15,0,0,15,30,0
17,5,0,21,43,0
14,0,1,12,27,0
10,1,0,11,22,0
18,5,0,18,41,0
12,4,0,11,27,0
17,0,1,30,48,0
20,1,0,28,49,0
19,5,1,38,63,0
15,0,0,36,51,0
10,2,0,30,42,0
74,4,4,13,95,0
96,29,6,17,148,0
109,16,6,12,143,0
113,6,9,10,138,0
90,24,8,20,142,0
106,19,10,17,152,0
96,7,6,4,113,0
102,21,42,3,168,1
140,35,50,0,225,1
105,33,29,4,171,1
134,26,27,1,188,1
123,35,45,1,204,1
128,31,26,0,185,1
105,32,43,0,180,1
137,13,31,5,186,1
148,37,46,2,233,1
105,14,35,2,156,1
148,17,42,5,212,1
116,22,30,3,171,1
143,28,46,1,218,1
30,24,13,13,80,0
74,23,35,10,142,1
67,5,36,17,125,1
59,11,33,25,128,1
34,21,39,16,110,0
72,24,10,9,115,0
73,12,32,5,122,1
26,8,8,24,66,0
47,5,7,28,87,0
33,10,6,29,78,0
39,8,13,20,80,0
36,5,14,22,77,0
53,9,15,25,102,0
37,9,10,30,86,0
54,8,4,27,93,0
20,8,15,26,69,0
47,29,28,9,113,1
51,27,10,20,108,0
114,11,40,20,185,1
73,13,19,9,114,0
28,19,27,5,79,0
105,20,20,11,156,0
68,24,15,14,121,0
112,16,30,11,169,1
120,30,28,15,193,1
38,27,12,18,95,0
94,17,14,15,140,0
107,28,45,8,188,1
100,16,49,7,172,1
145,15,20,9,189,1
133,17,22,8,180,1
117,36,41,10,204,1
113,26,26,8,173,1
101,20,21,9,151,0
149,33,45,10,237,1
134,35,26,7,202,1
106,11,45,9,171,1
121,37,34,6,198,1
97,13,11,15,136,0
91,17,18,29,155,1
57,16,13,19,105,0
110,10,10,20,150,0
71,14,17,30,132,1
89,25,20,24,158,1
87,16,15,14,132,0
106,12,16,9,143,0
78,10,19,20,127,0
61,10,16,27,114,1
74,19,15,24,132,1
56,20,11,25,112,1
106,22,16,18,162,0
10,1,1,12,24,0
12,4,1,33,50,0
16,4,0,16,36,0
18,1,0,18,37,0
19,2,0,36,57,0
18,4,1,35,58,0
17,0,0,31,48,0
18,1,0,16,35,0
15,4,0,37,56,0
11,5,0,14,30,0
11,5,0,22,38,0
12,2,1,37,52,0
18,1,1,34,54,0
19,1,0,11,31,0
11,4,1,26,42,0
18,3,0,28,49,0
12,4,1,37,54,0
11,1,1,29,42,0
19,5,1,29,54,0
18,4,0,11,33,0
16,4,0,29,49,0
19,4,1,33,57,0
15,3,1,12,31,0
16,4,1,28,49,0
11,4,0,20,35,0
93,4,1,16,114,0
114,12,7,18,151,0
56,7,5,20,88,0
92,23,3,19,137,0
99,6,6,7,118,0
108,14,6,9,137,0
66,20,2,16,104,0
147,26,44,5,222,1
139,27,29,1,196,1
119,31,36,5,191,1
114,30,21,2,167,0
103,27,21,4,155,0
105,17,29,4,155,1
124,29,41,1,195,1
118,19,34,1,172,1
101,37,32,0,170,1
109,11,48,1,169,1
143,12,23,3,181,1
143,40,30,0,213,1
128,16,34,0,178,1
14,25,14,16,69,0
99,10,11,15,135,0
67,1,22,14,104,0
42,2,29,9,82,0
92,3,33,21,149,1
91,16,28,9,144,1
25,9,10,28,72,0
37,5,12,29,83,0
55,6,12,29,102,0
49,8,8,26,91,0
69,9,3,20,101,0
38,6,6,24,74,0
40,8,12,21,81,0
53,5,3,20,81,0
21,8,4,28,61,0
24,7,4,20,55,0
47,24,24,9,104,0
90,30,32,8,160,1
120,21,22,14,177,1
120,12,40,13,185,1
66,14,21,7,108,0
89,24,12,6,131,0
80,17,16,5,118,0
114,21,10,9,154,0
94,20,7,10,131,0
70,18,28,5,121,1
56,17,15,8,96,0
141,15,20,6,182,1
150,19,46,7,222,1
119,37,22,8,186,1
144,14,44,5,207,1
110,25,46,6,187,1
138,15,31,10,194,1
140,35,41,5,221,1
103,24,28,8,163,1
142,27,30,5,204,1
149,13,22,9,193,1
126,40,39,8,213,1
78,15,14,28,135,1
102,15,11,29,157,1
96,22,20,12,150,0
110,24,15,14,163,0
97,22,17,13,149,0
53,19,11,18,101,0
82,8,17,29,136,1
91,24,18,29,162,1
102,6,14,35,157,1
109,6,15,18,148,0
78,16,13,27,134,1
66,12,16,33,127,1
100,17,15,22,154,1
15,1,1,25,42,0
16,1,0,33,50,0
19,4,0,26,49,0
10,0,1,34,45,0
14,0,0,28,42,0
13,2,0,22,37,0
18,5,1,20,44,0
18,4,0,18,40,0
11,3,0,26,40,0
13,1,0,24,38,0
19,5,1,15,40,0
11,3,1,28,43,0
11,1,1,40,53,0
18,4,1,28,51,0
15,2,1,16,34,0
20,0,0,27,47,0
14,5,0,17,36,0
11,3,1,10,25,0
18,5,0,22,45,0
12,4,0,16,32,0
10,2,0,24,36,0
20,0,1,36,57,0
20,1,0,29,50,0
16,4,0,24,44,0
18,3,0,22,43,0
88,11,10,3,112,0
114,5,9,7,135,0
103,3,9,17,132,0
81,16,7,14,118,0
94,1,9,3,107,0
56,11,9,15,91,0
80,16,5,10,111,0
138,35,47,4,224,1
123,27,22,4,176,1
114,30,36,2,182,1
122,30,37,2,191,1
148,10,28,2,188,1
127,38,48,0,213,1
113,32,44,1,190,1
131,26,40,1,198,1
108,27,44,5,184,1
109,19,49,3,180,1
125,15,28,3,171,1
139,30,35,4,208,1
103,35,50,2,190,1
64,13,40,12,129,1
79,1,10,30,120,1
50,2,7,14,73,0
84,18,18,28,148,1
99,16,39,26,180,1
42,3,27,18,90,0
53,2,29,24,108,0
63,10,8,28,109,0
24,8,3,20,55,0
46,8,6,26,86,0
20,7,8,26,61,0
41,8,7,27,83,0
44,5,3,28,80,0
33,6,14,28,81,0
30,9,7,25,71,0
68,7,5,25,105,0
28,29,26,5,88,0
96,20,14,18,148,0
24,15,26,13,78,0
70,21,32,18,141,1
49,21,11,20,101,0
51,22,12,16,101,0
84,12,15,15,126,0
99,18,7,20,144,0
106,10,9,8,133,0
6,11,34,20,71,0
59,29,15,16,119,0
139,25,41,5,210,1
109,12,49,6,176,1
124,24,47,9,204,1
135,29,39,7,210,1
137,15,37,7,196,1
119,28,46,9,202,1
127,21,28,5,181,1
109,37,44,9,199,1
145,27,35,7,214,1
133,36,28,6,203,1
138,19,36,5,198,1
73,5,20,10,108,0
83,11,14,33,141,1
89,8,10,19,126,0
99,19,18,24,160,1
54,17,14,8,93,0
58,18,14,6,96,0
56,16,12,9,93,0
77,6,20,5,108,0
85,6,18,17,126,0
105,14,13,32,164,1
96,21,11,24,152,1
66,22,17,16,121,0
88,15,19,14,136,0
16,1,1,24,42,0
13,1,0,11,25,0
13,5,1,23,42,0
19,5,0,37,61,0
19,1,0,31,51,0
11,5,0,19,35,0
18,3,0,32,53,0
17,1,1,38,57,0
17,3,0,20,40,0
18,4,1,19,42,0
19,3,0,24,46,0
16,3,0,15,34,0
12,5,1,21,39,0
17,3,0,36,56,0
19,4,1,21,45,0
13,5,0,20,38,0
14,0,1,37,52,0
14,5,0,39,58,0
13,1,0,19,33,0
18,5,1,25,49,0
15,1,1,15,32,0
19,2,0,30,51,0
18,2,1,27,48,0
13,1,0,38,52,0
19,2,0,32,53,0
116,0,1,9,126,0
60,12,8,15,95,0
82,15,0,19,116,0
67,23,7,3,100,0
59,27,10,18,114,0
66,6,9,5,86,0
120,10,3,16,149,0
121,22,30,0,173,1
130,27,39,5,201,1
139,31,44,3,217,1
129,14,43,5,191,1
131,28,43,5,207,1
119,39,24,1,183,1
142,25,34,5,206,1
123,22,22,3,170,1
106,19,38,4,167,0
115,39,20,2,176,1
111,17,32,1,161,1
144,26,50,3,223,0
126,31,48,2,207,1
73,22,21,29,145,1
28,7,25,18,78,0
31,10,40,9,90,0
51,14,33,14,112,1
22,7,39,23,91,0
46,5,11,21,83,0
72,22,21,27,142,1
70,5,5,29,109,0
28,9,9,24,70,0
44,5,11,23,83,0
27,6,13,30,76,0
20,6,6,23,55,0
29,7,3,28,67,0
20,6,5,27,58,0
65,9,15,22,111,0
36,5,6,20,67,0
99,21,21,6,147,0
101,21,34,18,174,1
98,29,34,12,173,1
113,20,7,13,153,0
75,24,27,7,133,1
71,21,38,11,141,1
119,13,32,7,171,1
114,11,39,13,177,1
99,26,8,11,144,0
39,12,21,9,81,0
114,26,16,20,176,1
120,32,39,9,200,1
143,24,35,6,208,1
121,28,21,5,175,1
134,23,28,10,195,1
103,13,37,10,163,1
122,12,48,10,192,1
145,39,23,6,213,1
105,13,48,10,176,1
144,13,40,10,207,1
103,18,40,5,166,1
120,15,34,8,177,1
56,19,16,13,104,0
56,5,17,14,92,0
108,15,13,5,141,0
58,23,14,34,129,1
58,13,11,33,115,1
76,24,14,15,129,0
69,8,13,28,118,1
54,9,12,10,85,0
89,7,10,10,116,0
110,18,18,10,156,0
86,12,17,18,133,0
82,7,16,9,114,0
102,5,19,11,137,0
16,5,0,21,42,0
11,3,1,39,54,0
18,5,0,11,34,0
12,0,1,32,45,0
15,4,1,39,59,0
15,4,0,26,45,0
13,1,0,30,44,0
12,3,0,28,43,0
17,2,1,20,40,0
14,5,1,33,53,0
16,3,1,11,31,0
18,2,1,13,34,0
12,2,1,17,32,0
17,4,1,15,37,0
18,1,1,25,45,0
20,1,1,10,32,0
15,1,0,21,37,0
11,3,1,34,49,0
19,0,1,13,33,0
10,3,0,14,27,0
17,5,1,17,40,0
16,1,0,11,28,0
11,0,1,33,45,0
10,5,0,39,54,0
12,3,0,32,47,0
106,16,10,10,142,0
69,18,0,12,99,0
103,26,6,12,147,0
99,25,6,6,136,0
85,9,4,11,109,0
109,0,3,8,120,0
106,27,1,6,140,0
133,28,31,3,195,1
108,39,34,5,186,1
101,12,48,1,162,1
145,11,29,1,186,1
112,33,29,3,177,1
111,18,32,4,165,1
133,39,44,2,218,1
115,34,37,5,191,1
135,35,38,3,211,1
142,40,28,3,213,1
124,11,27,2,164,1
122,29,31,5,187,1
101,19,23,5,148,0
72,5,15,20,112,0
100,13,23,9,145,0
32,10,33,8,83,0
42,25,37,12,116,1
81,25,40,20,166,1
56,18,9,23,106,0
84,9,31,17,141,1
36,9,8,28,81,0
32,5,11,27,75,0
26,7,15,27,75,0
34,5,5,22,66,0
66,9,6,30,111,0
69,10,4,24,107,0
44,7,9,20,80,0
58,10,5,27,100,0
27,6,14,30,77,0
19,21,25,15,80,0
39,15,30,8,92,0
109,21,10,12,152,0
93,10,9,15,127,0
73,16,12,11,112,0
111,18,29,16,174,1
37,20,10,19,86,0
74,23,13,20,130,0
32,28,35,6,101,0
34,23,19,17,93,0
59,25,9,20,113,0
145,12,24,8,189,1
118,17,28,8,171,1
145,20,47,8,220,1
140,25,46,10,221,1
120,35,43,7,205,1
126,24,31,7,188,1
106,22,43,5,176,1
137,40,28,9,214,1
108,40,25,6,179,1
135,15,50,6,206,1
121,21,49,8,199,1
59,6,20,6,91,0
59,13,18,27,117,1
103,7,15,15,140,0
56,14,14,31,115,1
106,23,12,9,150,0
109,5,16,17,147,0
110,5,20,11,146,0
86,15,15,23,139,1
91,18,19,26,154,1
99,19,15,28,161,1
93,14,20,17,144,0
89,25,13,23,150,1
107,15,12,24,158,1
16,5,0,14,35,0
14,5,1,20,40,0
18,3,0,24,45,0
12,3,0,40,55,0
14,4,1,27,46,0
18,5,1,15,39,0
10,4,1,23,38,0
10,5,0,14,29,0
14,3,0,28,45,0
10,2,0,38,50,0
19,0,0,32,51,0
20,3,0,19,42,0
18,3,0,14,35,0
11,2,0,12,25,0
17,1,1,13,32,0
10,0,1,36,47,0
17,0,0,32,49,0
20,5,1,22,48,0
12,3,0,17,32,0
13,0,0,31,44,0
11,1,1,35,48,0
18,2,0,19,39,0
15,0,1,24,40,0
14,3,0,25,42,0
12,0,1,16,29,0
85,24,5,5,119,0
71,22,5,2,100,0
108,4,5,3,120,0
63,29,5,15,112,0
62,12,3,18,95,0
118,15,3,11,147,0
90,21,2,14,127,0
141,30,31,1,203,1
126,31,33,2,192,1
112,26,30,4,172,1
112,12,38,4,166,1
144,14,33,4,195,1
127,13,36,1,177,1
146,10,44,5,205,1
146,22,26,4,198,1
101,10,48,5,164,1
104,19,24,4,151,0
150,20,43,0,213,1
110,35,45,2,192,1
139,15,28,2,184,1
99,17,32,7,155,1
22,15,7,19,63,0
11,12,21,24,68,0
47,20,18,16,101,0
54,1,35,26,116,1
26,16,13,16,71,0
99,18,39,19,175,1
31,9,11,28,79,0
24,8,13,23,68,0
21,7,9,20,57,0
60,10,5,25,100,0
29,9,12,21,71,0
37,7,14,28,86,0
53,7,11,22,93,0
35,5,15,25,80,0
53,6,10,28,97,0
114,18,17,8,157,0
95,28,22,9,154,0
62,23,38,19,142,1
70,28,12,12,122,0
35,20,10,8,73,0
60,23,10,20,113,0
40,22,25,9,96,0
53,21,6,11,91,0
99,16,38,7,160,1
86,21,31,18,156,1
79,28,35,13,155,1
146,25,33,8,212,1
116,24,36,6,182,1
107,14,44,5,170,1
115,20,27,9,171,1
113,23,43,6,185,1
102,20,31,5,158,1
138,27,21,7,193,1
146,13,38,9,206,1
139,33,41,7,220,1
130,24,48,9,211,1
135,31,34,8,208,1
106,22,16,20,164,0
109,23,14,26,172,1
108,24,19,10,161,0
50,16,16,11,93,0
102,22,17,10,151,0
72,25,10,27,134,1
91,13,18,13,135,0
67,19,11,8,105,0
61,14,10,5,90,0
107,13,14,28,162,1
91,5,12,34,142,1
106,18,13,27,164,1
107,14,10,18,149,0
17,4,1,20,42,0
11,4,1,30,46,0
11,4,0,23,38,0
16,3,1,36,56,0
11,0,1,30,42,0
15,4,1,25,45,0
16,5,0,27,48,0
14,3,1,15,33,0
